R 1080 720

NO textures/no.xpm

SO textures/so.xpm

WE textures/we.xpm

EA textures/ea.xpm
S  textures/sprite.xpm

F 151 ,151 ,151
C 42,42,42 

 111111111111111 
10000000000020021
10000000000000001
100010000000000011
100000000000000011
100000000000000011
10000000002000001
1000E000002000001
10000000002000001
10000000000000001
10012100000000001
10001000000000001
10000000002000001
10000000002000001
10000000002000001
 111111111111111