R 1080 720

NO  textures/no.xpm

SO textures/so.xpm

WE textures/we.xpm

EA textures/ea.xpm
S  textures/sprite.xpm

F 151,151,151
C 42,42,42

        1111111111111111111111111111111111111111
        1000000000110000000000000000000000000001
        1011000001110200002000000000000000000001
        1001000000000002000002001111111111111001
111111111011000001110000000000001           1001
100000000011000001110111110111111           1001
111101111111110111000000100011111111111111111001
111101111111110111010100100012020202020202021001
110000001101010111000000100010202020202020202001
100020000000000011000000100000000000000000000001
100000000000000011010100100000000000000000000001
11000001110101011111011110N010202020202020202001
11110111 1110101 1011110100012020202020202020111
11111111 1111111 11111111111111111111111111111
